111111111111111111111
1P00000000000000000E1
101111011100110111101
101101000000000101101
101100001101110111101
101001000000000001101
100001111111111111101
1C0000000000000000001
111111111111111111111
