1111111111111111111111111111111111111111
1P00000000000000000000000000000000000001
1111111011111111111011111111111111100011
1C000001000000000001000000000000000000C1
1011111010111111111010111111111111111011
1000000010000000000010000000000000000001
1011111010111111111110111111111111111011
1000000010000000000000000000000000000001
1011111110111111111111111111111111111011
1C000000001000000000000000000000000000C1
1111111010111111111011111111111111111011
1000000010000000010000000000000000000001
1011111110111111011110111100011111111011
1C000000001000000001000000000000000000E1
1011111011111111011011111111111111111011
1000000010000000010000000000000000000001
1111111010111111011010111111111111111011
1C00000000100000000000000000000000000001
1011111111111111111111111111111111100011
1111111111111111111111111111111111111111
