111111111111111111111111111111111111111111111111111111111111
1P0000000000000000000000000000000000000000000000000000000001
101111111111111111111111111111111111111111111111111111111101
1C00000000000000000000000000000000000000000000000000000000C1
101111111011111111111111111111111111111111101111111111111101
100000000010000000000000000000000000000000000000000000000001
101111111111101111111111111111111111111111111111111111111101
100000000000001000000000000000000000000000000000000000000001
101111111111101011111111111111111111111111111111111111111101
1C00000000000000100000000000000000000000000000000000000000C1
101111111111111011111111111111111111111111111111111111111101
100000000000001000000000000000000000000000000000000000000001
101111111111101111111111111111111111111111111111111111111101
100000000000000000000000000000000000000000000000000000000001
111111111111111111111111111111111111111111111111111111111101
1C00000000000000000000000000000000000000000000000000000000E1
101111111111111111111111111111111111111111111111111111111101
100000000000000000000000000000000000000000000000000000000001
101111111111001111111111111111111111111111111111111111111101
1C00000000000000000000000000000000000000000000000000000000C1
101111111111111111111111111111111111111111111111111111111101
100000000000000000000000000000000000000000000000000000000001
100111111111111111111111111111111111111111111111111111111101
100000000000000000000000000000000000000000000000000000000001
100001111111111111111111111111111111111111111111111111111101
100000000000000000000000000000000000000000000000000000000001
111111111111111111111111111111111111111111111111111111111111
